https://developer.bluetooth.org/gatt/descriptors/Pages/DescriptorsHomePage.aspx
Characteristic Extended Properties	org.bluetooth.descriptor.gatt.characteristic_extended_properties	0x2900
Characteristic User Description	org.bluetooth.descriptor.gatt.characteristic_user_description	0x2901
Client Characteristic Configuration	org.bluetooth.descriptor.gatt.client_characteristic_configuration	0x2902
Server Characteristic Configuration	org.bluetooth.descriptor.gatt.server_characteristic_configuration	0x2903
Characteristic Presentation Format	org.bluetooth.descriptor.gatt.characteristic_presentation_format	0x2904
Characteristic Aggregate Format	org.bluetooth.descriptor.gatt.characteristic_aggregate_format	0x2905
Valid Range	org.bluetooth.descriptor.valid_range	0x2906
External Report Reference	org.bluetooth.descriptor.external_report_reference	0x2907
Report Reference	org.bluetooth.descriptor.report_reference	0x2908
Number of Digitals	org.bluetooth.descriptor.number_of_digitals	0x2909
Value Trigger Setting	org.bluetooth.descriptor.value_trigger_setting	0x290A
Environmental Sensing Configuration	org.bluetooth.descriptor.es_configuration	0x290B
Environmental Sensing Measurement	org.bluetooth.descriptor.es_measurement	0x290C
Environmental Sensing Trigger Setting	org.bluetooth.descriptor.es_trigger_setting	0x290D
Time Trigger Setting	org.bluetooth.descriptor.time_trigger_setting	0x290E

https://developer.bluetooth.org/gatt/services/Pages/ServicesHome.aspx
Alert Notification Service	org.bluetooth.service.alert_notification	0x1811
Automation IO	org.bluetooth.service.automation_io	0x1815
Battery Service	org.bluetooth.service.battery_service	0x180F
Blood Pressure	org.bluetooth.service.blood_pressure	0x1810
Body Composition	org.bluetooth.service.body_composition	0x181B
Bond Management	org.bluetooth.service.bond_management	0x181E
Continuous Glucose Monitoring	org.bluetooth.service.continuous_glucose_monitoring	0x181F
Current Time Service	org.bluetooth.service.current_time	0x1805
Cycling Power	org.bluetooth.service.cycling_power	0x1818
Cycling Speed and Cadence	org.bluetooth.service.cycling_speed_and_cadence	0x1816
Device Information	org.bluetooth.service.device_information	0x180A
Environmental Sensing	org.bluetooth.service.environmental_sensing	0x181A
Fitness Machine	org.bluetooth.service.fitness_machine	0x1826
Generic Access	org.bluetooth.service.generic_access	0x1800
Generic Attribute	org.bluetooth.service.generic_attribute	0x1801
Glucose	org.bluetooth.service.glucose	0x1808
Health Thermometer	org.bluetooth.service.health_thermometer	0x1809
Heart Rate	org.bluetooth.service.heart_rate	0x180D
HTTP Proxy	org.bluetooth.service.http_proxy	0x1823
Human Interface Device	org.bluetooth.service.human_interface_device	0x1812
Immediate Alert	org.bluetooth.service.immediate_alert	0x1802
Indoor Positioning	org.bluetooth.service.indoor_positioning	0x1821
Internet Protocol Support	org.bluetooth.service.internet_protocol_support	0x1820
Link Loss	org.bluetooth.service.link_loss	0x1803
Location and Navigation	org.bluetooth.service.location_and_navigation	0x1819
Next DST Change Service	org.bluetooth.service.next_dst_change	0x1807
Object Transfer	org.bluetooth.service.object_transfer	0x1825
Phone Alert Status Service	org.bluetooth.service.phone_alert_status	0x180E
Pulse Oximeter	org.bluetooth.service.pulse_oximeter	0x1822
Reference Time Update Service	org.bluetooth.service.reference_time_update	0x1806
Running Speed and Cadence	org.bluetooth.service.running_speed_and_cadence	0x1814
Scan Parameters	org.bluetooth.service.scan_parameters	0x1813
Transport Discovery	org.bluetooth.service.transport_discovery	0x1824
Tx Power	org.bluetooth.service.tx_power	0x1804
User Data	org.bluetooth.service.user_data	0x181C
Weight Scale	org.bluetooth.service.weight_scale	0x181D

https://developer.bluetooth.org/gatt/characteristics/Pages/CharacteristicsHome.aspx
Aerobic Heart Rate Lower Limit	org.bluetooth.characteristic.aerobic_heart_rate_lower_limit	0x2A7E
Aerobic Heart Rate Upper Limit	org.bluetooth.characteristic.aerobic_heart_rate_upper_limit	0x2A84
Aerobic Threshold	org.bluetooth.characteristic.aerobic_threshold	0x2A7F
Age	org.bluetooth.characteristic.age	0x2A80
Aggregate	org.bluetooth.characteristic.aggregate	0x2A5A
Alert Category ID	org.bluetooth.characteristic.alert_category_id	0x2A43
Alert Category ID Bit Mask	org.bluetooth.characteristic.alert_category_id_bit_mask	0x2A42
Alert Level	org.bluetooth.characteristic.alert_level	0x2A06
Alert Notification Control Point	org.bluetooth.characteristic.alert_notification_control_point	0x2A44
Alert Status	org.bluetooth.characteristic.alert_status	0x2A3F
Altitude	org.bluetooth.characteristic.altitude	0x2AB3
Anaerobic Heart Rate Lower Limit	org.bluetooth.characteristic.anaerobic_heart_rate_lower_limit	0x2A81
Anaerobic Heart Rate Upper Limit	org.bluetooth.characteristic.anaerobic_heart_rate_upper_limit	0x2A82
Anaerobic Threshold	org.bluetooth.characteristic.anaerobic_threshold	0x2A83
Analog	org.bluetooth.characteristic.analog	0x2A58
Apparent Wind Direction	org.bluetooth.characteristic.apparent_wind_direction	0x2A73
Apparent Wind Speed	org.bluetooth.characteristic.apparent_wind_speed	0x2A72
Appearance	org.bluetooth.characteristic.gap.appearance	0x2A01
Barometric Pressure Trend	org.bluetooth.characteristic.barometric_pressure_trend	0x2AA3
Battery Level	org.bluetooth.characteristic.battery_level	0x2A19
Blood Pressure Feature	org.bluetooth.characteristic.blood_pressure_feature	0x2A49
Blood Pressure Measurement	org.bluetooth.characteristic.blood_pressure_measurement	0x2A35
Body Composition Feature	org.bluetooth.characteristic.body_composition_feature	0x2A9B
Body Composition Measurement	org.bluetooth.characteristic.body_composition_measurement	0x2A9C
Body Sensor Location	org.bluetooth.characteristic.body_sensor_location	0x2A38
Bond Management Control Point	org.bluetooth.characteristic.bond_management_control_point	0x2AA4
Bond Management Feature	org.bluetooth.characteristic.bond_management_feature	0x2AA5
Boot Keyboard Input Report	org.bluetooth.characteristic.boot_keyboard_input_report	0x2A22
Boot Keyboard Output Report	org.bluetooth.characteristic.boot_keyboard_output_report	0x2A32
Boot Mouse Input Report	org.bluetooth.characteristic.boot_mouse_input_report	0x2A33
Central Address Resolution	org.bluetooth.characteristic.gap.central_address_resolution_support	0x2AA6
CGM Feature	org.bluetooth.characteristic.cgm_feature	0x2AA8
CGM Measurement	org.bluetooth.characteristic.cgm_measurement	0x2AA7
CGM Session Run Time	org.bluetooth.characteristic.cgm_session_run_time	0x2AAB
CGM Session Start Time	org.bluetooth.characteristic.cgm_session_start_time	0x2AAA
CGM Specific Ops Control Point	org.bluetooth.characteristic.cgm_specific_ops_control_point	0x2AAC
CGM Status	org.bluetooth.characteristic.cgm_status	0x2AA9
Cross Trainer Data	org.bluetooth.characteristic.cross_trainer_data	0x2ACE
CSC Feature	org.bluetooth.characteristic.csc_feature	0x2A5C
CSC Measurement	org.bluetooth.characteristic.csc_measurement	0x2A5B
Current Time	org.bluetooth.characteristic.current_time	0x2A2B
Cycling Power Control Point	org.bluetooth.characteristic.cycling_power_control_point	0x2A66
Cycling Power Feature	org.bluetooth.characteristic.cycling_power_feature	0x2A65
Cycling Power Measurement	org.bluetooth.characteristic.cycling_power_measurement	0x2A63
Cycling Power Vector	org.bluetooth.characteristic.cycling_power_vector	0x2A64
Database Change Increment	org.bluetooth.characteristic.database_change_increment	0x2A99
Date of Birth	org.bluetooth.characteristic.date_of_birth	0x2A85
Date of Threshold Assessment	org.bluetooth.characteristic.date_of_threshold_assessment	0x2A86
Date Time	org.bluetooth.characteristic.date_time	0x2A08
Day Date Time	org.bluetooth.characteristic.day_date_time	0x2A0A
Day of Week	org.bluetooth.characteristic.day_of_week	0x2A09
Descriptor Value Changed	org.bluetooth.characteristic.descriptor_value_changed	0x2A7D
Device Name	org.bluetooth.characteristic.gap.device_name	0x2A00
Dew Point	org.bluetooth.characteristic.dew_point	0x2A7B
Digital	org.bluetooth.characteristic.digital	0x2A56
DST Offset	org.bluetooth.characteristic.dst_offset	0x2A0D
Elevation	org.bluetooth.characteristic.elevation	0x2A6C
Email Address	org.bluetooth.characteristic.email_address	0x2A87
Exact Time 256	org.bluetooth.characteristic.exact_time_256	0x2A0C
Fat Burn Heart Rate Lower Limit	org.bluetooth.characteristic.fat_burn_heart_rate_lower_limit	0x2A88
Fat Burn Heart Rate Upper Limit	org.bluetooth.characteristic.fat_burn_heart_rate_upper_limit	0x2A89
Firmware Revision String	org.bluetooth.characteristic.firmware_revision_string	0x2A26
First Name	org.bluetooth.characteristic.first_name	0x2A8A
Fitness Machine Control Point	org.bluetooth.characteristic.fitness_machine_control_point	0x2AD9
Fitness Machine Feature	org.bluetooth.characteristic.fitness_machine_feature	0x2ACC
Fitness Machine Status	org.bluetooth.characteristic.fitness_machine_status	0x2ADA
Five Zone Heart Rate Limits	org.bluetooth.characteristic.five_zone_heart_rate_limits	0x2A8B
Floor Number	org.bluetooth.characteristic.floor_number	0x2AB2
Gender	org.bluetooth.characteristic.gender	0x2A8C
Glucose Feature	org.bluetooth.characteristic.glucose_feature	0x2A51
Glucose Measurement	org.bluetooth.characteristic.glucose_measurement	0x2A18
Glucose Measurement Context	org.bluetooth.characteristic.glucose_measurement_context	0x2A34
Gust Factor	org.bluetooth.characteristic.gust_factor	0x2A74
Hardware Revision String	org.bluetooth.characteristic.hardware_revision_string	0x2A27
Heart Rate Control Point	org.bluetooth.characteristic.heart_rate_control_point	0x2A39
Heart Rate Max	org.bluetooth.characteristic.heart_rate_max	0x2A8D
Heart Rate Measurement	org.bluetooth.characteristic.heart_rate_measurement	0x2A37
Heat Index	org.bluetooth.characteristic.heat_index	0x2A7A
Height	org.bluetooth.characteristic.height	0x2A8E
HID Control Point	org.bluetooth.characteristic.hid_control_point	0x2A4C
HID Information	org.bluetooth.characteristic.hid_information	0x2A4A
Hip Circumference	org.bluetooth.characteristic.hip_circumference	0x2A8F
HTTP Control Point	org.bluetooth.characteristic.http_control_point	0x2ABA
HTTP Entity Body	org.bluetooth.characteristic.http_entity_body	0x2AB9
HTTP Headers	org.bluetooth.characteristic.http_headers	0x2AB7
HTTP Status Code	org.bluetooth.characteristic.http_status_code	0x2AB8
HTTPS Security	org.bluetooth.characteristic.https_security	0x2ABB
Humidity	org.bluetooth.characteristic.humidity	0x2A6F
IEEE 11073-20601 Regulatory Certification Data List	org.bluetooth.characteristic.ieee_11073-20601_regulatory_certification_data_list	0x2A2A
Indoor Bike Data	org.bluetooth.characteristic.indoor_bike_data	0x2AD2
Indoor Positioning Configuration	org.bluetooth.characteristic.indoor_positioning_configuration	0x2AAD
Intermediate Cuff Pressure	org.bluetooth.characteristic.intermediate_cuff_pressure	0x2A36
Intermediate Temperature	org.bluetooth.characteristic.intermediate_temperature	0x2A1E
Irradiance	org.bluetooth.characteristic.irradiance	0x2A77
Language	org.bluetooth.characteristic.language	0x2AA2
Last Name	org.bluetooth.characteristic.last_name	0x2A90
Latitude	org.bluetooth.characteristic.latitude	0x2AAE
LN Control Point	org.bluetooth.characteristic.ln_control_point	0x2A6B
LN Feature	org.bluetooth.characteristic.ln_feature	0x2A6A
Local East Coordinate	org.bluetooth.characteristic.local_east_coordinate	0x2AB1
Local North Coordinate	org.bluetooth.characteristic.local_north_coordinate	0x2AB0
Local Time Information	org.bluetooth.characteristic.local_time_information	0x2A0F
Location and Speed	org.bluetooth.characteristic.location_and_speed	0x2A67
Location Name	org.bluetooth.characteristic.location_name	0x2AB5
Longitude	org.bluetooth.characteristic.longitude	0x2AAF
Magnetic Declination	org.bluetooth.characteristic.magnetic_declination	0x2A2C
Magnetic Flux Density - 2D	org.bluetooth.characteristic.magnetic_flux_density_2D	0x2AA0
Magnetic Flux Density - 3D	org.bluetooth.characteristic.magnetic_flux_density_3D	0x2AA1
Manufacturer Name String	org.bluetooth.characteristic.manufacturer_name_string	0x2A29
Maximum Recommended Heart Rate	org.bluetooth.characteristic.maximum_recommended_heart_rate	0x2A91
Measurement Interval	org.bluetooth.characteristic.measurement_interval	0x2A21
Model Number String	org.bluetooth.characteristic.model_number_string	0x2A24
Navigation	org.bluetooth.characteristic.navigation	0x2A68
New Alert	org.bluetooth.characteristic.new_alert	0x2A46
Object Action Control Point	org.bluetooth.characteristic.object_action_control_point	0x2AC5
Object Changed	org.bluetooth.characteristic.object_changed	0x2AC8
Object First-Created	org.bluetooth.characteristic.object_first_created	0x2AC1
Object ID	org.bluetooth.characteristic.object_id	0x2AC3
Object Last-Modified	org.bluetooth.characteristic.object_last_modified	0x2AC2
Object List Control Point	org.bluetooth.characteristic.object_list_control_point	0x2AC6
Object List Filter	org.bluetooth.characteristic.object_list_filter	0x2AC7
Object Name	org.bluetooth.characteristic.object_name	0x2ABE
Object Properties	org.bluetooth.characteristic.object_properties	0x2AC4
Object Size	org.bluetooth.characteristic.object_size	0x2AC0
Object Type	org.bluetooth.characteristic.object_type	0x2ABF
OTS Feature	org.bluetooth.characteristic.ots_feature	0x2ABD
Peripheral Preferred Connection Parameters	org.bluetooth.characteristic.gap.peripheral_preferred_connection_parameters	0x2A04
Peripheral Privacy Flag	org.bluetooth.characteristic.gap.peripheral_privacy_flag	0x2A02
PLX Continuous Measurement	org.bluetooth.characteristic.plx_continuous_measurement	0x2A5F
PLX Features	org.bluetooth.characteristic.plx_features	0x2A60
PLX Spot-Check Measurement	org.bluetooth.characteristic.plx_spot_check_measurement	0x2A5E
PnP ID	org.bluetooth.characteristic.pnp_id	0x2A50
Pollen Concentration	org.bluetooth.characteristic.pollen_concentration	0x2A75
Position Quality	org.bluetooth.characteristic.position_quality	0x2A69
Pressure	org.bluetooth.characteristic.pressure	0x2A6D
Protocol Mode	org.bluetooth.characteristic.protocol_mode	0x2A4E
Rainfall	org.bluetooth.characteristic.rainfall	0x2A78
Reconnection Address	org.bluetooth.characteristic.gap.reconnection_address	0x2A03
Record Access Control Point	org.bluetooth.characteristic.record_access_control_point	0x2A52
Reference Time Information	org.bluetooth.characteristic.reference_time_information	0x2A14
Report	org.bluetooth.characteristic.report	0x2A4D
Report Map	org.bluetooth.characteristic.report_map	0x2A4B
Resolvable Private Address Only	org.bluetooth.characteristic.resolvable_private_address_only	0x2AC9
Resting Heart Rate	org.bluetooth.characteristic.resting_heart_rate	0x2A92
Ringer Control Point	org.bluetooth.characteristic.ringer_control_point	0x2A40
Ringer Setting	org.bluetooth.characteristic.ringer_setting	0x2A41
Rower Data	org.bluetooth.characteristic.rower_data	0x2AD1
RSC Feature	org.bluetooth.characteristic.rsc_feature	0x2A54
RSC Measurement	org.bluetooth.characteristic.rsc_measurement	0x2A53
SC Control Point	org.bluetooth.characteristic.sc_control_point	0x2A55
Scan Interval Window	org.bluetooth.characteristic.scan_interval_window	0x2A4F
Scan Refresh	org.bluetooth.characteristic.scan_refresh	0x2A31
Sensor Location	org.bluetooth.characteristic.sensor_location	0x2A5D
Serial Number String	org.bluetooth.characteristic.serial_number_string	0x2A25
Service Changed	org.bluetooth.characteristic.gatt.service_changed	0x2A05
Software Revision String	org.bluetooth.characteristic.software_revision_string	0x2A28
Sport Type for Aerobic and Anaerobic Thresholds	org.bluetooth.characteristic.sport_type_for_aerobic_and_anaerobic_thresholds	0x2A93
Stair Climber Data	org.bluetooth.characteristic.stair_climber_data	0x2AD0
Step Climber Data	org.bluetooth.characteristic.step_climber_data	0x2ACF
Supported Heart Rate Range	org.bluetooth.characteristic.supported_heart_rate_range	0x2AD7
Supported Inclination Range	org.bluetooth.characteristic.supported_inclination_range	0x2AD5
Supported New Alert Category	org.bluetooth.characteristic.supported_new_alert_category	0x2A47
Supported Power Range	org.bluetooth.characteristic.supported_power_range	0x2AD8
Supported Resistance Level Range	org.bluetooth.characteristic.supported_resistance_level_range	0x2AD6
Supported Speed Range	org.bluetooth.characteristic.supported_speed_range	0x2AD4
Supported Unread Alert Category	org.bluetooth.characteristic.supported_unread_alert_category	0x2A48
System ID	org.bluetooth.characteristic.system_id	0x2A23
TDS Control Point	org.bluetooth.characteristic.tds_control_point	0x2ABC
Temperature	org.bluetooth.characteristic.temperature	0x2A6E
Temperature Measurement	org.bluetooth.characteristic.temperature_measurement	0x2A1C
Temperature Type	org.bluetooth.characteristic.temperature_type	0x2A1D
Three Zone Heart Rate Limits	org.bluetooth.characteristic.three_zone_heart_rate_limits	0x2A94
Time Accuracy	org.bluetooth.characteristic.time_accuracy	0x2A12
Time Source	org.bluetooth.characteristic.time_source	0x2A13
Time Update Control Point	org.bluetooth.characteristic.time_update_control_point	0x2A16
Time Update State	org.bluetooth.characteristic.time_update_state	0x2A17
Time with DST	org.bluetooth.characteristic.time_with_dst	0x2A11
Time Zone	org.bluetooth.characteristic.time_zone	0x2A0E
Training Status	org.bluetooth.characteristic.training_status	0x2AD3
Treadmill Data	org.bluetooth.characteristic.treadmill_data	0x2ACD
True Wind Direction	org.bluetooth.characteristic.true_wind_direction	0x2A71
True Wind Speed	org.bluetooth.characteristic.true_wind_speed	0x2A70
Two Zone Heart Rate Limit	org.bluetooth.characteristic.two_zone_heart_rate_limit	0x2A95
Tx Power Level	org.bluetooth.characteristic.tx_power_level	0x2A07
Uncertainty	org.bluetooth.characteristic.uncertainty	0x2AB4
Unread Alert Status	org.bluetooth.characteristic.unread_alert_status	0x2A45
URI	org.bluetooth.characteristic.uri	0x2AB6
User Control Point	org.bluetooth.characteristic.user_control_point	0x2A9F
User Index	org.bluetooth.characteristic.user_index	0x2A9A
UV Index	org.bluetooth.characteristic.uv_index	0x2A76
VO2 Max	org.bluetooth.characteristic.vo2_max	0x2A96
Waist Circumference	org.bluetooth.characteristic.waist_circumference	0x2A97
Weight	org.bluetooth.characteristic.weight	0x2A98
Weight Measurement	org.bluetooth.characteristic.weight_measurement	0x2A9D
Weight Scale Feature	org.bluetooth.characteristic.weight_scale_feature	0x2A9E
Wind Chill	org.bluetooth.characteristic.wind_chill	0x2A79
